date,amount,recovered,avg,sum,coronaEvents,recovered_cum,recoveredAvg
12-Feb-2020,0,0,,7,,104,
13-Feb-2020,0,0,0,7,,104,0
14-Feb-2020,0,0,0,7,,104,0
15-Feb-2020,0,0,0,7,,104,0
16-Feb-2020,0,0,0,7,,104,0
17-Feb-2020,0,0,0,7,,104,0
18-Feb-2020,0,0,0,7,,104,0
19-Feb-2020,0,0,0,7,,104,0
20-Feb-2020,0,1,0,7,,105,0
21-Feb-2020,1,0,0,8,,105,0
22-Feb-2020,0,0,0,8,,105,0
23-Feb-2020,0,0,0,8,,105,0
24-Feb-2020,1,0,0,9,,105,0
25-Feb-2020,0,0,0,9,,105,0
26-Feb-2020,0,0,0,9,,105,0
27-Feb-2020,1,0,0,10,,105,0
28-Feb-2020,3,0,0,13,,105,0
29-Feb-2020,0,0,0,13,,105,0
01-Mar-2020,1,0,0,14,,105,0
02-Mar-2020,5,0,0,19,,105,0
03-Mar-2020,3,0,1,22,,105,0
04-Mar-2020,0,0,1,22,,105,0
05-Mar-2020,9,0,1,31,,105,0
06-Mar-2020,4,0,3,35,,105,0
07-Mar-2020,4,0,3,39,,105,0
08-Mar-2020,9,0,3,48,,105,0
09-Mar-2020,4,0,4,52,,105,0
10-Mar-2020,33,0,4,85,,105,0
11-Mar-2020,18,0,9,103,,105,0
12-Mar-2020,23,0,11,126,,105,0
13-Mar-2020,35,1,13,161,,106,0
14-Mar-2020,29,0,18,190,סגר ראשון ,106,0
15-Mar-2020,40,0,21,230,,106,0
16-Mar-2020,73,0,26,303,,106,0
17-Mar-2020,94,2,35,397,,108,0
18-Mar-2020,125,2,44,522,,110,0
19-Mar-2020,134,4,59,656,,114,0
20-Mar-2020,168,1,75,824,,115,1
21-Mar-2020,209,0,94,1033,,115,1
22-Mar-2020,252,5,120,1285,,120,1
23-Mar-2020,349,5,150,1634,,125,2
24-Mar-2020,420,5,190,2054,,130,2
25-Mar-2020,423,6,236,2477,,136,3
26-Mar-2020,520,9,279,2997,,145,3
27-Mar-2020,431,18,334,3428,,163,4
28-Mar-2020,476,9,372,3904,,172,6
29-Mar-2020,528,14,410,4432,,186,8
30-Mar-2020,549,33,449,4981,,219,9
31-Mar-2020,738,43,478,5719,,262,13
01-Apr-2020,693,32,523,6412,,294,18
02-Apr-2020,724,78,562,7136,,372,22
03-Apr-2020,600,54,591,7736,,426,32
04-Apr-2020,427,52,615,8163,,478,37
05-Apr-2020,584,100,608,8747,,578,43
06-Apr-2020,449,118,616,9196,,696,56
07-Apr-2020,376,120,602,9572,,816,68
08-Apr-2020,340,105,550,9912,,921,79
09-Apr-2020,340,110,500,10252,,1031,89
10-Apr-2020,355,123,445,10607,,1154,94
11-Apr-2020,342,120,410,10949,,1274,104
12-Apr-2020,551,258,398,11500,,1532,113
13-Apr-2020,437,277,393,11937,,1809,136
14-Apr-2020,394,286,391,12331,,2095,159
15-Apr-2020,305,276,394,12636,,2371,182
16-Apr-2020,296,328,389,12932,,2699,207
17-Apr-2020,297,356,382,13229,,3055,238
18-Apr-2020,288,249,374,13517,,3304,271
19-Apr-2020,274,380,366,13791,פתיחת משק חלקית לאחר סגר ראשון,3684,290
20-Apr-2020,297,448,327,14088,,4132,307
21-Apr-2020,279,371,307,14367,,4503,331
22-Apr-2020,226,391,290,14593,,4894,344
23-Apr-2020,274,326,279,14867,,5220,360
24-Apr-2020,250,337,276,15117,,5557,360
25-Apr-2020,159,375,269,15276,,5932,357
26-Apr-2020,82,429,251,15358,,6361,375
27-Apr-2020,127,467,223,15485,,6828,382
28-Apr-2020,161,564,199,15646,,7392,385
29-Apr-2020,82,350,182,15728,,7742,412
30-Apr-2020,143,426,162,15871,,8168,406
01-May-2020,116,422,143,15987,,8590,421
02-May-2020,57,275,124,16044,,8865,433
03-May-2020,26,285,109,16070,,9150,419
04-May-2020,55,257,101,16125,,9407,398
05-May-2020,33,316,91,16158,,9723,368
06-May-2020,65,260,73,16223,,9983,333
07-May-2020,61,225,70,16284,,10208,320
08-May-2020,33,222,59,16317,,10430,291
09-May-2020,20,91,47,16337,,10521,262
10-May-2020,29,168,41,16366,,10689,236
11-May-2020,39,327,42,16405,,11016,219
12-May-2020,23,258,40,16428,,11274,229
13-May-2020,39,177,38,16467,,11451,221
14-May-2020,22,239,34,16489,,11690,209
15-May-2020,12,160,29,16501,,11850,211
16-May-2020,5,101,26,16506,,11951,202
17-May-2020,15,150,24,16521,,12101,204
18-May-2020,27,273,22,16548,,12374,201
19-May-2020,22,150,20,16570,,12524,194
20-May-2020,15,109,20,16585,,12633,178
21-May-2020,18,121,16,16603,,12754,168
22-May-2020,19,161,16,16622,,12915,152
23-May-2020,5,43,17,16627,,12958,152
24-May-2020,13,114,17,16640,,13072,143
25-May-2020,22,132,17,16662,,13204,138
26-May-2020,50,91,16,16712,,13295,118
27-May-2020,40,60,20,16752,פתיחת משק מלאה לאחר סגר ראשון,13355,110
28-May-2020,77,112,23,16829,,13467,103
29-May-2020,113,39,32,16942,,13506,101
30-May-2020,29,40,45,16971,,13546,84
31-May-2020,87,60,49,17058,,13606,84
01-Jun-2020,100,67,59,17158,,13673,76
02-Jun-2020,122,53,70,17280,,13726,67
03-Jun-2020,96,27,81,17376,,13753,61
04-Jun-2020,142,42,89,17518,,13795,56
05-Jun-2020,127,37,98,17645,,13832,46
06-Jun-2020,78,24,100,17723,,13856,46
07-Jun-2020,140,42,107,17863,,13898,44
08-Jun-2020,179,39,115,18042,,13937,41
09-Jun-2020,174,46,126,18216,,13983,37
10-Jun-2020,241,51,133,18457,,14034,36
11-Jun-2020,193,55,154,18650,,14089,40
12-Jun-2020,184,53,161,18834,,14142,42
13-Jun-2020,149,41,169,18983,,14183,44
14-Jun-2020,137,50,180,19120,,14233,46
15-Jun-2020,200,88,179,19320,,14321,47
16-Jun-2020,298,51,182,19618,,14372,54
17-Jun-2020,268,48,200,19886,,14420,55
18-Jun-2020,303,50,204,20189,,14470,55
19-Jun-2020,311,57,219,20500,,14527,54
20-Jun-2020,161,37,238,20661,,14564,55
21-Jun-2020,174,49,239,20835,,14613,54
22-Jun-2020,344,60,245,21179,,14673,54
23-Jun-2020,452,84,265,21631,,14757,50
24-Jun-2020,485,72,287,22116,,14829,55
25-Jun-2020,516,76,318,22632,,14905,58
26-Jun-2020,464,130,349,23096,,15035,62
27-Jun-2020,397,50,370,23493,,15085,72
28-Jun-2020,383,139,404,23876,,15224,74
29-Jun-2020,759,166,434,24635,,15390,87
30-Jun-2020,789,127,493,25424,,15517,102
01-Jul-2020,968,99,541,26392,,15616,108
02-Jul-2020,1154,124,610,27546,,15740,112
03-Jul-2020,941,119,702,28487,,15859,119
04-Jul-2020,820,76,770,29307,,15935,117
05-Jul-2020,825,143,830,30132,,16078,121
06-Jul-2020,1128,193,893,31260,,16271,122
07-Jul-2020,1384,172,946,32644,,16443,125
08-Jul-2020,1330,226,1031,33974,,16669,132
09-Jul-2020,1522,225,1083,35496,,16894,150
10-Jul-2020,1405,212,1135,36901,,17106,164
11-Jul-2020,1168,191,1202,38069,,17297,178
12-Jul-2020,1236,336,1251,39305,,17633,194
13-Jul-2020,1717,362,1310,41022,,17995,222
14-Jul-2020,1601,314,1394,42623,,18309,246
15-Jul-2020,1873,361,1425,44496,,18670,266
16-Jul-2020,1936,508,1503,46432,,19178,285
17-Jul-2020,1601,481,1562,48033,,19659,326
18-Jul-2020,1444,447,1590,49477,,20106,364
19-Jul-2020,1016,516,1629,50493,,20622,401
20-Jul-2020,1886,626,1598,52379,,21248,427
21-Jul-2020,2004,640,1622,54383,,21888,464
22-Jul-2020,2040,3706,1680,56423,,25594,511
23-Jul-2020,1987,6703,1703,58410,,32297,989
24-Jul-2020,1824,1587,1711,60234,,33884,1874
25-Jul-2020,1110,587,1743,61344,,34471,2032
26-Jul-2020,1040,2722,1695,62384,,37193,2052
27-Jul-2020,2048,1755,1698,64432,,38948,2367
28-Jul-2020,2120,1549,1721,66552,,40497,2528
29-Jul-2020,1957,1393,1738,68509,,41890,2658
30-Jul-2020,1786,1675,1726,70295,,43565,2328
31-Jul-2020,1359,1294,1697,71654,,44859,1609
01-Aug-2020,623,534,1631,72277,,45393,1567
02-Aug-2020,708,2426,1561,72985,,47819,1560
03-Aug-2020,1799,1778,1514,74784,,49597,1518
04-Aug-2020,1726,1641,1478,76510,,51238,1521
05-Aug-2020,1686,1476,1422,78196,,52714,1534
06-Aug-2020,1675,1742,1383,79871,,54456,1546
07-Aug-2020,1761,1206,1368,81632,,55662,1555
08-Aug-2020,754,603,1425,82386,,56265,1543
09-Aug-2020,922,2324,1444,83308,,58589,1553
10-Aug-2020,1697,1391,1474,85005,,59980,1538
11-Aug-2020,1823,984,1460,86828,,60964,1483
12-Aug-2020,1617,1132,1474,88445,,62096,1389
13-Aug-2020,1640,1303,1464,90085,,63399,1340
14-Aug-2020,1389,986,1459,91474,,64385,1277
15-Aug-2020,754,566,1406,92228,,64951,1246
16-Aug-2020,1069,2217,1406,93297,,67168,1240
17-Aug-2020,1649,1185,1427,94946,,68353,1225
18-Aug-2020,1647,1114,1420,96593,,69467,1196
19-Aug-2020,1639,1469,1395,98232,,70936,1214
20-Aug-2020,1485,1425,1398,99717,,72361,1262
21-Aug-2020,1491,1037,1376,101208,,73398,1280
22-Aug-2020,710,662,1390,101918,,74060,1287
23-Aug-2020,964,2111,1384,102882,,76171,1301
24-Aug-2020,1901,1397,1369,104783,,77568,1286
25-Aug-2020,1958,793,1405,106741,,78361,1316
26-Aug-2020,1984,3627,1449,108725,,81988,1270
27-Aug-2020,2106,1509,1499,110831,,83497,1578
28-Aug-2020,1833,1831,1587,112664,,85328,1590
29-Aug-2020,908,706,1636,113572,,86034,1704
30-Aug-2020,1099,2252,1664,114671,,88286,1710
31-Aug-2020,2171,1464,1684,116842,,89750,1730
01-Sep-2020,2254,1007,1722,119096,,90757,1740
02-Sep-2020,3194,1392,1765,122290,,92149,1770
03-Sep-2020,2666,1792,1937,124956,,93941,1451
04-Sep-2020,2623,1187,2017,127579,,95128,1492
05-Sep-2020,1504,883,2130,129083,,96011,1400
06-Sep-2020,2176,2389,2215,131259,,98400,1425
07-Sep-2020,3386,1589,2369,134645,,99989,1444
08-Sep-2020,3488,1423,2543,138133,,101412,1462
09-Sep-2020,3991,1461,2719,142124,,102873,1522
10-Sep-2020,4153,1971,2833,146277,,104844,1532
11-Sep-2020,3973,1769,3045,150250,,106613,1557
12-Sep-2020,2718,1259,3238,152968,,107872,1640
13-Sep-2020,3172,3261,3412,156140,,111133,1694
14-Sep-2020,4803,2391,3554,160943,,113524,1819
15-Sep-2020,5528,2258,3756,166471,,115782,1933
16-Sep-2020,4568,2786,4048,171039,,118568,2052
17-Sep-2020,5378,3704,4130,176417,,122272,2242
18-Sep-2020,5333,2833,4305,181750,סגר שני,125105,2489
19-Sep-2020,3809,1435,4500,185559,,126540,2641
20-Sep-2020,2576,2468,4655,188135,,129008,2666
21-Sep-2020,3870,4638,4570,192005,,133646,2553
22-Sep-2020,7017,3500,4437,199022,,137146,2874
23-Sep-2020,7142,3806,4650,206164,,140952,3052
24-Sep-2020,8259,4570,5017,214423,,145522,3197
25-Sep-2020,8386,4122,5429,222809,,149644,3321
26-Sep-2020,5880,2390,5865,228689,,152034,3505
27-Sep-2020,3436,5666,6161,232125,,157700,3642
28-Sep-2020,1154,2161,6284,233279,,159861,4098
29-Sep-2020,4988,5763,5896,238267,,165624,3745
30-Sep-2020,9051,5109,5606,247318,,170733,4068
01-Oct-2020,7720,5745,5879,255038,,176478,4254
02-Oct-2020,7053,5565,5802,262091,,182043,4422
03-Oct-2020,2593,3483,5611,264684,,185526,4628
04-Oct-2020,2932,8095,5142,267616,,193621,4784
05-Oct-2020,5701,6940,5070,273317,,200561,5131
06-Oct-2020,4717,6398,5719,278034,,206959,5814
07-Oct-2020,4153,4884,5681,282187,,211843,5905
08-Oct-2020,3752,4786,4981,285939,,216629,5872
09-Oct-2020,2954,5083,4414,288893,,221712,5735
10-Oct-2020,916,3778,3828,289809,,225490,5667
11-Oct-2020,1638,7531,3589,291447,,233021,5709
12-Oct-2020,3154,5500,3404,294601,,238521,5628
13-Oct-2020,2335,5703,3040,296936,,244224,5422
14-Oct-2020,2118,5819,2700,299054,,250043,5323
15-Oct-2020,1609,5395,2409,300663,,255438,5457
16-Oct-2020,1496,3469,2103,302159,,258907,5544
17-Oct-2020,410,2501,1895,302569,,261408,5313
18-Oct-2020,923,4886,1822,303492,פתיחת סגר שני,266294,5131
19-Oct-2020,1516,2324,1720,305008,,268618,4753
20-Oct-2020,1192,1788,1486,306200,,270406,4299
21-Oct-2020,1170,3110,1323,307370,,273516,3740
22-Oct-2020,1031,3098,1188,308401,,276614,3353
23-Oct-2020,849,2422,1105,309250,,279036,3025
24-Oct-2020,247,1296,1013,309497,,280332,2875
25-Oct-2020,604,2656,989,310101,,282988,2703
26-Oct-2020,883,1281,944,310984,,284269,2384
27-Oct-2020,885,953,853,311869,,285222,2235
28-Oct-2020,724,1287,809,312593,,286509,2116
29-Oct-2020,647,1435,746,313240,,287944,1856
30-Oct-2020,681,1057,691,313921,,289001,1618
31-Oct-2020,228,795,667,314149,,289796,1423
01-Nov-2020,657,1502,664,314806,,291298,1352
02-Nov-2020,792,910,672,315598,,292208,1187
03-Nov-2020,844,721,659,316442,,292929,1134
04-Nov-2020,769,630,653,317211,,293559,1101
05-Nov-2020,568,840,659,317779,,294399,1007
06-Nov-2020,689,886,648,318468,,295285,922
07-Nov-2020,212,680,649,318680,הקלות סגר שני – פתיחת חנויות רחוב,295965,897
08-Nov-2020,535,679,647,319215,,296644,881
09-Nov-2020,723,919,629,319938,,297563,763
10-Nov-2020,673,335,620,320611,,297898,765
11-Nov-2020,768,1079,595,321379,,298977,709
12-Nov-2020,837,1199,595,322216,,300176,774
13-Nov-2020,761,731,633,322977,,300907,825
14-Nov-2020,292,419,644,323269,,301326,803
15-Nov-2020,627,961,655,323896,,302287,765
16-Nov-2020,874,653,668,324770,,302940,806
17-Nov-2020,830,576,690,325600,,303516,768
18-Nov-2020,797,788,712,326397,,304304,802
19-Nov-2020,771,748,716,327168,,305052,761
20-Nov-2020,772,665,707,327940,,305717,696
21-Nov-2020,423,447,709,328363,,306164,687
22-Nov-2020,763,993,727,329126,,307157,691
23-Nov-2020,961,652,747,330087,,307809,695
24-Nov-2020,859,541,759,330946,,308350,695
25-Nov-2020,1081,838,763,332027,,309188,690
26-Nov-2020,1085,921,804,333112,,310109,697
27-Nov-2020,1033,679,849,334145,הקלות סגר שני – פיילוט קניונים,310788,722
28-Nov-2020,582,412,886,334727,,311200,724
29-Nov-2020,1026,1098,909,335753,,312298,719
30-Nov-2020,1257,726,946,337010,,313024,734
01-Dec-2020,1200,696,989,338210,,313720,745
02-Dec-2020,1588,833,1037,339798,,314553,767
03-Dec-2020,1448,1422,1110,341246,,315975,766
04-Dec-2020,1515,859,1162,342761,,316834,838
05-Dec-2020,1000,589,1230,343761,,317423,863
06-Dec-2020,1357,1387,1290,345118,,318810,889
07-Dec-2020,1863,905,1337,346981,,319715,930
08-Dec-2020,1769,888,1424,348750,,320603,955
09-Dec-2020,1869,1022,1505,350619,,321625,983
10-Dec-2020,2007,1429,1545,352626,,323054,1010
11-Dec-2020,1835,1142,1625,354461,,324196,1011
12-Dec-2020,1298,913,1671,355759,,325109,1051
13-Dec-2020,1727,1891,1714,357486,,327000,1098
14-Dec-2020,2322,1257,1766,359808,,328257,1170
15-Dec-2020,2893,1196,1832,362701,,329453,1220
16-Dec-2020,2860,1612,1993,365561,,331065,1264
17-Dec-2020,2847,1938,2134,368408,,333003,1348
18-Dec-2020,2792,1544,2254,371200,,334547,1421
19-Dec-2020,1889,1080,2391,373089,,335627,1478
20-Dec-2020,3095,2544,2475,376184,תחילת חיסונים מנה 1,338171,1502
21-Dec-2020,3860,1549,2671,380044,,339720,1595
22-Dec-2020,4381,1619,2890,384425,,341339,1637
23-Dec-2020,4038,2013,3103,388463,,343352,1698
24-Dec-2020,4050,2856,3271,392513,,346208,1755
25-Dec-2020,4005,2387,3443,396518,,348595,1886
26-Dec-2020,2660,1794,3616,399178,,350389,2006
27-Dec-2020,3534,4180,3727,402712,סגר שלישי,354569,2108
28-Dec-2020,5522,2467,3789,408234,,357036,2342
29-Dec-2020,5632,2375,4027,413866,,359411,2473
30-Dec-2020,5869,3715,4205,419735,,363126,2581
31-Dec-2020,5866,4235,4467,425601,,367361,2824
01-Jan-2021,6013,3436,4726,431614,,370797,3021
02-Jan-2021,4212,2032,5013,435826,,372829,3171
03-Jan-2021,5232,5544,5235,441058,,378373,3205
04-Jan-2021,8424,3070,5478,449482,,381443,3400
05-Jan-2021,8230,2947,5892,457712,,384390,3486
06-Jan-2021,7884,4756,6263,465596,,389146,3568
07-Jan-2021,7663,5836,6551,473259,,394982,3717
08-Jan-2021,8162,4822,6808,481421,הידוק סגר שלישי,399804,3945
09-Jan-2021,5164,3063,7115,486585,,402867,4143
10-Jan-2021,6954,8323,7251,493539,תחילת חיסונים מנה 2,411190,4291
11-Jan-2021,9731,4829,7497,503270,,416019,4688
12-Jan-2021,9296,4551,7684,512566,,420570,4939
13-Jan-2021,9472,7989,7836,522038,,428559,5168
14-Jan-2021,9299,9154,8063,531337,,437713,5630
15-Jan-2021,8430,7970,8296,539767,,445683,6104
16-Jan-2021,5086,4262,8335,544853,,449945,6554
17-Jan-2021,5660,10868,8324,550513,,460813,6725
18-Jan-2021,10123,6143,8139,560636,,466956,7089
19-Jan-2021,8633,5486,8195,569269,,472442,7276
20-Jan-2021,8361,8737,8100,577630,,481179,7410
21-Jan-2021,7268,9935,7941,584898,,491114,7517
22-Jan-2021,7387,8423,7651,592285,,499537,7628
23-Jan-2021,2447,4163,7502,594732,,503700,7693
24-Jan-2021,4936,10498,7125,599668,,514198,7679
25-Jan-2021,8718,5596,7022,608386,,519794,7626
26-Jan-2021,7817,5074,6821,616203,,524868,7548
27-Jan-2021,7750,8647,6704,623953,,533515,7489
28-Jan-2021,7196,9188,6617,631149,,542703,7476
29-Jan-2021,6776,7521,6607,637925,,550224,7369
30-Jan-2021,2627,3532,6520,640552,,553756,7241
31-Jan-2021,5239,10063,6545,645791,,563819,7150
01-Feb-2021,8929,5109,6589,654720,,568928,7088
02-Feb-2021,8023,4391,6619,662743,,573319,7019
03-Feb-2021,7463,8163,6648,670206,,581482,6921
04-Feb-2021,7262,8109,6607,677468,,589591,6852
05-Feb-2021,6599,7226,6617,684067,,596817,6698
06-Feb-2021,2661,3043,6591,686728,,599860,6656
07-Feb-2021,4605,9685,6596,691333,פתיחת סגר שלשי ,609545,6586
08-Feb-2021,7856,4972,6506,699189,,614517,6532
09-Feb-2021,6169,4902,6352,705358,,619419,6512
10-Feb-2021,5676,8219,6087,711034,,627638,6585
11-Feb-2021,5068,8711,5832,716102,,636349,6593
12-Feb-2021,4674,7197,5519,720776,,643546,6679
13-Feb-2021,1890,3384,5244,722666,,646930,6675
14-Feb-2021,3489,9578,5134,726155,,656508,6724
15-Feb-2021,5199,4849,4974,731354,,661357,6709
16-Feb-2021,4583,3730,4595,735937,,665087,6691
17-Feb-2021,4168,6487,4368,740105,,671574,6524
18-Feb-2021,3338,7449,4153,743443,,679023,6276
19-Feb-2021,3794,5886,3905,747237,,684909,6096
20-Feb-2021,1255,3372,3780,748492,,688281,5909
21-Feb-2021,3115,7367,3689,751607,פתיחה חלקית של המשק לאחר סגר שלישי,695648,5907
22-Feb-2021,4812,3647,3636,756419,,699295,5591
23-Feb-2021,4443,3154,3580,760862,,702449,5419
24-Feb-2021,4376,5342,3560,765238,,707791,5337
25-Feb-2021,3820,4981,3590,769058,,712772,5173
26-Feb-2021,3819,3734,3659,772877,,716506,4821
27-Feb-2021,1443,1561,3662,774320,,718067,4513
28-Feb-2021,3031,5621,3689,777351,,723688,4255
01-Mar-2021,4851,2729,3677,782202,,726417,4005
02-Mar-2021,4394,2913,3683,786596,,729330,3874
03-Mar-2021,4669,4574,3676,791265,,733904,3840
04-Mar-2021,3659,4759,3718,794924,,738663,3730
05-Mar-2021,3695,3958,3695,798619,,742621,3698
06-Mar-2021,1840,1910,3677,800459,,744531,3730
07-Mar-2021,2367,5677,3734,802826,פתיחת משק מלאה לאחר סגר שלישי,750208,3780
08-Mar-2021,3796,2666,3639,806622,,752874,3788
09-Mar-2021,3127,2907,3488,809749,,755781,3779
10-Mar-2021,2843,4538,3307,812592,,760319,3778
11-Mar-2021,2553,4954,3046,815145,,765273,3773
12-Mar-2021,2414,3880,2888,817559,,769153,3801
13-Mar-2021,787,2015,2705,818346,,771168,3790
14-Mar-2021,1418,5774,2555,819764,,776942,3805
15-Mar-2021,2130,2608,2419,821894,,779550,3819
16-Mar-2021,1566,2228,2181,823460,,781778,3810
17-Mar-2021,1541,3609,1958,825001,,785387,3713
18-Mar-2021,1256,3573,1772,826257,,788960,3581
19-Mar-2021,1087,2536,1587,827344,,791496,3383
20-Mar-2021,351,1452,1397,827695,,792948,3191
21-Mar-2021,681,3470,1335,828376,,796418,3111
22-Mar-2021,987,1676,1230,829363,,798094,2782
23-Mar-2021,694,736,1067,830057,,798830,2649
24-Mar-2021,479,2239,942,830536,,801069,2436
25-Mar-2021,902,2093,790,831438,,803162,2240
26-Mar-2021,544,1490,740,831982,,804652,2028
27-Mar-2021,241,856,662,832223,,805508,1879
28-Mar-2021,132,877,646,832355,,806385,1794
29-Mar-2021,385,1466,568,832740,,807851,1423
30-Mar-2021,455,810,482,833195,,808661,1393
31-Mar-2021,499,1073,448,833694,,809734,1404
01-Apr-2021,334,1061,451,834028,,810795,1237
02-Apr-2021,419,634,370,834447,,811429,1090
03-Apr-2021,124,460,352,834571,,811889,968
04-Apr-2021,197,1050,335,834768,,812939,911
05-Apr-2021,383,509,344,835151,,813448,936
06-Apr-2021,307,492,344,835458,,813940,799
07-Apr-2021,274,425,323,835732,,814365,754
08-Apr-2021,212,638,291,835944,,815003,661
09-Apr-2021,226,577,273,836170,,815580,601
10-Apr-2021,86,386,246,836256,,815966,593
11-Apr-2021,141,777,240,836397,,816743,582
12-Apr-2021,224,359,232,836621,,817102,543
13-Apr-2021,198,379,210,836819,,817481,522
14-Apr-2021,195,483,194,837014,,817964,505
15-Apr-2021,95,261,183,837109,,818225,514
16-Apr-2021,110,365,166,837219,,818590,460
17-Apr-2021,88,211,149,837307,,818801,430
18-Apr-2021,199,543,150,837506,פתיחת לימודים ללא קפסולות,819344,405
19-Apr-2021,145,200,158,837651,,819544,371
20-Apr-2021,174,225,147,837825,,819769,348
21-Apr-2021,121,234,143,837946,,820003,326
22-Apr-2021,160,334,133,838106,,820337,291
23-Apr-2021,112,265,142,838218,,820602,301
24-Apr-2021,36,113,142,838254,,820715,287
25-Apr-2021,82,191,135,838336,,820906,273
26-Apr-2021,103,145,118,838439,,821051,223
27-Apr-2021,117,148,112,838556,,821199,215
28-Apr-2021,107,177,104,838663,,821376,204
29-Apr-2021,100,169,102,838763,,821545,196
30-Apr-2021,79,130,93,838842,,821675,172
01-May-2021,15,71,89,838857,,821746,153
02-May-2021,59,217,86,838916,,821963,147
03-May-2021,87,152,82,839003,,822115,151
04-May-2021,66,108,80,839069,,822223,152
05-May-2021,73,139,73,839142,,822362,146
06-May-2021,54,144,68,839196,,822506,140
07-May-2021,34,88,61,839230,,822594,137
08-May-2021,16,64,55,839246,,822658,131
09-May-2021,33,145,55,839279,,822803,130
10-May-2021,70,57,51,839349,,822860,120
11-May-2021,40,85,49,839389,,822945,106
12-May-2021,29,94,45,839418,,823039,103
13-May-2021,35,74,39,839453,,823113,96
14-May-2021,27,64,36,839480,,823177,86
15-May-2021,20,45,35,839500,,823222,83
16-May-2021,37,99,36,839537,,823321,80
17-May-2021,15,18,36,839552,,823339,74
18-May-2021,25,91,29,839577,,823430,68
19-May-2021,56,89,26,839633,,823519,69
20-May-2021,35,74,30,839668,,823593,68
21-May-2021,22,34,30,839690,,823627,68
22-May-2021,12,25,30,839702,,823652,64
23-May-2021,28,85,28,839730,,823737,61
24-May-2021,30,30,27,839760,,823767,59
25-May-2021,22,42,29,839782,,823809,61
26-May-2021,16,36,29,839798,,823845,54
27-May-2021,16,38,23,839814,,823883,46
28-May-2021,18,40,20,839832,,823923,41
29-May-2021,13,17,20,839845,,823940,42
30-May-2021,4,69,20,839849,,824009,41
31-May-2021,14,28,17,839863,,824037,38
01-Jun-2021,35,36,14,839898,,824073,38
02-Jun-2021,13,48,16,839911,,824121,37
03-Jun-2021,11,130,16,839922,,824251,39
04-Jun-2021,31,12,15,839953,,824263,52
05-Jun-2021,6,6,17,839959,,824269,48
06-Jun-2021,5,54,16,839964,,824323,47
07-Jun-2021,7,52,16,839971,,824375,44
08-Jun-2021,30,15,15,840001,,824390,48
09-Jun-2021,9,21,14,840010,,824411,45
10-Jun-2021,18,32,14,840028,,824443,41
11-Jun-2021,18,19,15,840046,,824462,27
12-Jun-2021,5,14,13,840051,,824476,28
13-Jun-2021,3,28,13,840054,,824504,29
14-Jun-2021,26,21,12,840080,,824525,25
15-Jun-2021,27,15,15,840107,,824540,21
16-Jun-2021,14,10,15,840121,,824550,21
17-Jun-2021,29,45,15,840150,,824595,19
18-Jun-2021,35,12,17,840185,,824607,21
19-Jun-2021,47,9,19,840232,,824616,20
20-Jun-2021,53,86,25,840285,,824702,20
21-Jun-2021,125,38,33,840410,,824740,28
22-Jun-2021,113,10,47,840523,,824750,30
23-Jun-2021,153,25,59,840676,,824775,30
24-Jun-2021,247,41,79,840923,,824816,32
25-Jun-2021,240,16,110,841163,,824832,31
26-Jun-2021,122,15,139,841285,,824847,32
27-Jun-2021,145,72,150,841430,,824919,33
28-Jun-2021,289,57,163,841719,,824976,31
29-Jun-2021,303,75,187,842022,הפעלת התו הירוק במתחמים מעל 100 איש בגל הרביעי,825051,33
30-Jun-2021,347,93,214,842369,,825144,43
01-Jul-2021,299,164,241,842668,,825308,52
02-Jul-2021,369,136,249,843037,,825444,70
03-Jul-2021,189,96,267,843226,,825540,87
04-Jul-2021,352,286,277,843578,,825826,99
05-Jul-2021,504,195,306,844082,,826021,129
06-Jul-2021,550,174,337,844632,,826195,149
07-Jul-2021,527,244,372,845159,,826439,163
08-Jul-2021,473,326,398,845632,,826765,185
09-Jul-2021,544,247,423,846176,,827012,208
10-Jul-2021,261,133,448,846437,,827145,224
11-Jul-2021,443,424,458,846880,,827569,229
12-Jul-2021,765,280,471,847645,,827849,249
13-Jul-2021,750,326,509,848395,,828175,261
14-Jul-2021,774,450,537,849169,,828625,282
15-Jul-2021,877,562,572,850046,,829187,312
16-Jul-2021,1148,472,630,851194,,829659,346
17-Jul-2021,441,202,716,851635,,829861,378
18-Jul-2021,837,643,742,852472,,830504,388
19-Jul-2021,1401,445,798,853873,,830949,419
20-Jul-2021,1414,379,889,855287,,831328,442
21-Jul-2021,1374,641,984,856661,,831969,450
22-Jul-2021,1289,779,1070,857950,,832748,477
23-Jul-2021,1442,696,1129,859392,,833444,508
24-Jul-2021,972,407,1171,860364,,833851,540
25-Jul-2021,1437,1305,1247,861801,,835156,570
26-Jul-2021,2135,834,1332,863936,,835990,664
27-Jul-2021,2303,898,1437,866239,,836888,720
28-Jul-2021,2200,1150,1564,868439,,838038,794
29-Jul-2021,2180,1356,1682,870619,,839394,867
30-Jul-2021,2466,1229,1809,873085,,840623,949
31-Jul-2021,2104,582,1956,875189,,841205,1025
01-Aug-2021,2126,1906,2117,877315,תחילת חיסונים מנה 3,843111,1050
02-Aug-2021,3862,1110,2216,881177,,844221,1136
03-Aug-2021,3312,1251,2463,884489,,845472,1175
04-Aug-2021,3510,1841,2607,887999,,847313,1226
05-Aug-2021,3887,2257,2794,891886,,849570,1325
06-Aug-2021,3889,1905,3038,895775,,851475,1453
07-Aug-2021,2936,1009,3241,898711,,852484,1550
08-Aug-2021,3447,3261,3360,902158,,855745,1611
09-Aug-2021,6382,2002,3549,908540,,857747,1804
10-Aug-2021,5859,2352,3909,914399,,860099,1932
11-Aug-2021,6027,3256,4272,920426,,863355,2089
12-Aug-2021,6154,3624,4632,926580,,866979,2291
13-Aug-2021,5975,3239,4956,932555,,870218,2487
14-Aug-2021,4232,1574,5254,936787,,871792,2677
15-Aug-2021,5198,5067,5439,941985,,876859,2758
16-Aug-2021,8795,3412,5689,950780,,880271,3016
17-Aug-2021,7993,3318,6034,958773,,883589,3217
18-Aug-2021,8037,5274,6339,966810,,888863,3355
19-Aug-2021,7842,5843,6626,974652,,894706,3644
20-Aug-2021,7908,5462,6867,982560,,900168,3961
21-Aug-2021,5416,2716,7143,987976,,902884,4278
22-Aug-2021,6593,8175,7312,994569,,911059,4441
23-Aug-2021,10112,4979,7512,1004681,,916038,4885
24-Aug-2021,10085,4877,7700,1014766,,920915,5109
25-Aug-2021,9245,7702,7999,1024011,,928617,5332
26-Aug-2021,9124,8566,8171,1033135,,937183,5679
27-Aug-2021,8699,7888,8354,1041834,,945071,6068
28-Aug-2021,7279,3932,8467,1049113,,949003,6414
29-Aug-2021,6792,10659,8733,1055905,,959662,6588
30-Aug-2021,11157,6869,8762,1067062,,966531,6943
31-Aug-2021,10447,6344,8911,1077509,,972875,7213
01-Sep-2021,11301,9291,8963,1088810,,982166,7422
02-Sep-2021,11345,10510,9257,1100155,,992676,7649
03-Sep-2021,9912,9288,9574,1110067,,1001964,7927
04-Sep-2021,5067,5164,9747,1115134,,1007128,8127
05-Sep-2021,5867,12357,9431,1121001,,1019485,8303
06-Sep-2021,10870,9139,9299,1131871,,1028624,8546
07-Sep-2021,6865,4906,9258,1138736,,1033530,8870
08-Sep-2021,3320,5840,8746,1142056,,1039370,8665
09-Sep-2021,7960,13133,7606,1150016,,1052503,8172
10-Sep-2021,9901,11405,7123,1159917,,1063908,8546
11-Sep-2021,10291,5774,7121,1170208,,1069682,8849
12-Sep-2021,7808,12711,7867,1178016,,1082393,8936
13-Sep-2021,10953,7664,8145,1188969,,1090057,8986
14-Sep-2021,9858,6822,8156,1198827,,1096879,8776
15-Sep-2021,8865,10008,8584,1207692,,1106887,9049
16-Sep-2021,3286,3812,9376,1210978,,1110699,9645
17-Sep-2021,5024,6854,8708,1216002,,1117553,8313
18-Sep-2021,8617,3735,8012,1224619,,1121288,7663
19-Sep-2021,6554,15889,7773,1231173,,1137177,7372
20-Sep-2021,8828,10708,7593,1240001,,1147885,7826
21-Sep-2021,4827,4124,7290,1244828,,1152009,8261
22-Sep-2021,6025,11557,6571,1250853,,1163566,7875
23-Sep-2021,6452,9723,6165,1257305,,1173289,8097
24-Sep-2021,4990,7776,6618,1262295,,1181065,8941
25-Sep-2021,2653,3155,6613,1264948,,1184220,9073
26-Sep-2021,3874,5355,5761,1268822,,1189575,8990
27-Sep-2021,5246,8928,5378,1274068,,1198503,7485
28-Sep-2021,2441,5186,4866,1276509,,1203689,7231
29-Sep-2021,3636,9536,4525,1280145,,1213225,7382
30-Sep-2021,4398,6775,4184,1284543,,1220000,7094
01-Oct-2021,3622,4945,3891,1288165,,1224945,6673
02-Oct-2021,1739,3644,3695,1289904,,1228589,6268
03-Oct-2021,2700,7655,3565,1292604,הנחיות חדשות בתו הירוק ,1236244,6338
04-Oct-2021,3278,4477,3397,1295882,,1240721,6667
05-Oct-2021,2556,4071,3116,1298438,,1244792,6031
06-Oct-2021,2428,4648,3132,1300866,,1249440,5871
07-Oct-2021,2119,3943,2960,1302985,,1253383,5173
08-Oct-2021,2024,3127,2634,1305009,,1256510,4769
09-Oct-2021,1040,3005,2406,1306049,,1259515,4509
10-Oct-2021,1490,5188,2306,1307539,,1264703,4418
11-Oct-2021,2343,2691,2133,1309882,,1267394,4065
12-Oct-2021,1816,2939,2000,1311698,,1270333,3810
13-Oct-2021,1772,3219,1894,1313470,,1273552,3648
14-Oct-2021,1345,3140,1800,1314815,,1276692,3444
15-Oct-2021,1575,2197,1690,1316390,,1278889,3329
16-Oct-2021,740,1201,1625,1317130,,1280090,3197
17-Oct-2021,1221,3016,1583,1318351,,1283106,2939
18-Oct-2021,1508,1835,1544,1319859,,1284941,2629
19-Oct-2021,1150,1748,1425,1321009,,1286689,2506
20-Oct-2021,1036,2307,1330,1322045,,1288996,2336
21-Oct-2021,992,2329,1225,1323037,,1291325,2206
22-Oct-2021,983,1736,1174,1324020,,1293061,2090
23-Oct-2021,332,954,1090,1324352,,1294015,2024
24-Oct-2021,842,2249,1031,1325194,,1296264,1989
25-Oct-2021,930,1350,977,1326124,,1297614,1879
26-Oct-2021,729,1369,895,1326853,,1298983,1810
27-Oct-2021,648,1511,834,1327501,,1300494,1756
28-Oct-2021,661,1367,779,1328162,,1301861,1642
29-Oct-2021,617,1174,732,1328779,,1303035,1505
30-Oct-2021,226,641,679,1329005,,1303676,1424
31-Oct-2021,528,1391,664,1329533,,1305067,1380
01-Nov-2021,691,818,619,1330224,היתר כניסת תיירים לישראל על פי מתווה,1305885,1257
02-Nov-2021,666,872,585,1330890,,1306757,1181
03-Nov-2021,616,973,576,1331506,,1307730,1110
04-Nov-2021,519,993,572,1332025,,1308723,1033
05-Nov-2021,558,659,551,1332583,,1309382,980
06-Nov-2021,199,431,543,1332782,,1309813,906
07-Nov-2021,502,881,539,1333284,,1310694,876
08-Nov-2021,566,496,535,1333850,,1311190,803
09-Nov-2021,473,522,518,1334323,,1311712,757
10-Nov-2021,498,715,490,1334821,,1312427,707
11-Nov-2021,393,696,473,1335214,,1313123,671
12-Nov-2021,448,603,455,1335662,,1313726,628
13-Nov-2021,225,357,439,1335887,,1314083,620
14-Nov-2021,398,683,443,1336285,,1314766,610
15-Nov-2021,535,457,428,1336820,,1315223,581
16-Nov-2021,558,511,424,1337378,,1315734,576
17-Nov-2021,483,538,436,1337861,,1316272,574
18-Nov-2021,469,609,434,1338330,,1316881,549
19-Nov-2021,508,380,445,1338838,,1317261,536
20-Nov-2021,237,291,453,1339075,,1317552,505
21-Nov-2021,453,669,455,1339528,,1318221,495
22-Nov-2021,715,317,463,1340243,תחילת מבצע חיסונים לילדים בני 5-11,1318538,493
23-Nov-2021,604,335,489,1340847,,1318873,473
24-Nov-2021,543,507,495,1341390,,1319380,448
25-Nov-2021,540,557,504,1341930,,1319937,444
26-Nov-2021,540,394,514,1342470,,1320331,436
27-Nov-2021,169,308,518,1342639,,1320639,438
28-Nov-2021,542,770,509,1343181,,1321409,441
29-Nov-2021,697,453,521,1343878,,1321862,455
30-Nov-2021,577,549,519,1344455,,1322411,474
01-Dec-2021,563,631,515,1345018,,1323042,505
02-Dec-2021,519,644,518,1345537,,1323686,523
03-Dec-2021,486,520,515,1346023,,1324206,535
04-Dec-2021,248,315,507,1346271,,1324521,553
05-Dec-2021,539,721,518,1346810,,1325242,554
06-Dec-2021,739,447,518,1347549,,1325689,547
07-Dec-2021,813,504,524,1348362,,1326193,546
08-Dec-2021,714,632,558,1349076,,1326825,540
09-Dec-2021,647,677,579,1349723,,1327502,540
10-Dec-2021,607,549,598,1350330,,1328051,545
11-Dec-2021,236,542,615,1350566,,1328593,549
12-Dec-2021,492,706,613,1351058,,1329299,581
13-Dec-2021,771,424,606,1351829,,1329723,579
14-Dec-2021,702,463,611,1352531,,1330186,576
15-Dec-2021,789,663,595,1353320,,1330849,570
16-Dec-2021,862,832,606,1354182,,1331681,574
17-Dec-2021,877,697,637,1355059,,1332378,597
18-Dec-2021,393,427,675,1355452,,1332805,618
19-Dec-2021,1021,733,698,1356473,,1333538,601
20-Dec-2021,1330,502,773,1357803,,1334040,605
21-Dec-2021,1200,439,853,1359003,,1334479,616
22-Dec-2021,1416,631,924,1360419,,1335110,613
23-Dec-2021,1514,668,1014,1361933,,1335778,608
24-Dec-2021,1789,666,1107,1363722,,1336444,585
25-Dec-2021,806,456,1237,1364528,,1336900,580
26-Dec-2021,1805,901,1296,1366333,,1337801,585
27-Dec-2021,2973,769,1408,1369306,,1338570,609
28-Dec-2021,3243,1217,1643,1372549,,1339787,647
29-Dec-2021,4072,1217,1935,1376621,,1341004,758
30-Dec-2021,5079,1334,2314,1381700,,1342338,842
31-Dec-2021,5492,1157,2823,1387192,,1343495,937
01-Jan-2022,4230,1051,3352,1391422,,1344546,1007
02-Jan-2022,6609,1882,3842,1398031,תחילת חיסונים מנה 4 לבני 60 ומעלה ולצוותים רפואיים,1346428,1092
03-Jan-2022,10952,1459,4528,1408983,,1347887,1232
04-Jan-2022,12642,1851,5668,1421625,,1349738,1331
05-Jan-2022,18562,2713,7010,1440187,שינוי מדיניות בדיקות ובידודים - אנטיגן קובע מאומתים,1352451,1421
06-Jan-2022,19107,3550,9080,1459294,,1356001,1635
07-Jan-2022,22000,3709,11084,1481294,,1359710,1951
08-Jan-2022,22874,3143,13443,1504168,,1362853,2316
09-Jan-2022,31155,6198,16106,1535323,,1369051,2615
10-Jan-2022,41423,5033,19613,1576746,,1374084,3231
11-Jan-2022,47433,7001,23966,1624179,,1381085,3742
12-Jan-2022,48551,11787,28936,1672730,,1392872,4478
13-Jan-2022,49223,58023,33220,1721953,,1450895,5774
14-Jan-2022,45817,20088,37522,1767770,,1470983,13556
15-Jan-2022,45064,15863,40925,1812834,,1486846,15896
16-Jan-2022,64749,39580,44095,1877583,,1526426,17713
17-Jan-2022,72023,45001,48894,1949606,,1571427,22482
18-Jan-2022,73835,48396,53265,2023441,,1619823,28191
19-Jan-2022,75024,94564,57037,2098465,,1714387,34105
20-Jan-2022,75079,27965,60819,2173544,,1742352,45930
21-Jan-2022,65609,88599,64513,2239153,,1830951,41636
22-Jan-2022,67903,69634,67340,2307056,,1900585,51424
23-Jan-2022,85207,77317,70603,2392263,,1977902,59105
24-Jan-2022,83702,75530,73525,2475965,,2053432,64496
25-Jan-2022,76334,61362,75194,2552299,,2114794,68857
26-Jan-2022,67874,65670,75551,2620173,,2180464,70710
27-Jan-2022,57720,65485,74529,2677893,,2245949,66582
28-Jan-2022,53758,48866,72049,2731651,,2294815,71942
29-Jan-2022,49429,97644,70356,2781080,,2392459,66266
30-Jan-2022,74508,77483,67717,2855588,,2469942,70267
31-Jan-2022,67845,66043,66189,2923433,,2535985,70291
01-Feb-2022,60547,62845,63924,2983980,,2598830,68936
02-Feb-2022,60906,44251,61668,3044886,,2643081,69148
03-Feb-2022,46770,56022,60673,3091656,,2699103,66088
04-Feb-2022,38256,78588,59109,3129912,,2777691,64736
05-Feb-2022,33659,32963,56894,3163571,,2810654,68982
06-Feb-2022,52722,82721,54641,3216293,,2893375,59742
07-Feb-2022,44012,58066,51529,3260305,,2951441,60490
08-Feb-2022,38267,47259,48124,3298572,,2998700,59350
09-Feb-2022,37397,33195,44941,3335969,,3031895,57124
10-Feb-2022,27922,35207,41583,3363891,,3067102,55544
11-Feb-2022,22510,45777,38890,3386401,,3112879,52571
12-Feb-2022,18043,26496,36641,3404444,,3139375,47884
13-Feb-2022,31591,43400,34410,3436035,,3182775,46960
14-Feb-2022,23665,67558,31391,3459700,,3250333,41342
15-Feb-2022,20422,28234,28485,3480122,,3278567,42698
16-Feb-2022,21288,25213,25935,3501410,,3303780,39981
17-Feb-2022,15412,23930,23634,3516822,,3327710,38840
18-Feb-2022,12593,32688,21847,3529415,,3360398,37229
19-Feb-2022,10362,19311,20430,3539777,,3379709,35359
20-Feb-2022,17687,27858,19333,3557464,,3407567,34333
21-Feb-2022,12989,26528,17347,3570453,,3434095,32113
22-Feb-2022,12137,17882,15821,3582590,,3451977,26251
23-Feb-2022,11942,14182,14638,3594532,,3466159,24772
24-Feb-2022,9137,15739,13303,3603669,,3481898,23197
25-Feb-2022,7673,22242,12406,3611342,,3504140,22026
26-Feb-2022,5990,13420,11703,3617332,,3517560,20534
27-Feb-2022,10872,14565,11079,3628204,,3532125,19693
28-Feb-2022,8393,13764,10105,3636597,,3545889,17794
01-Mar-2022,7732,11815,9449,3644329,,3557704,15970
02-Mar-2022,8280,8488,8819,3652609,,3566192,15103
03-Mar-2022,999,7397,8296,3653608,,3573589,14290
