date,tests,positive,local,incoming,incoming_tests
07-Apr-2021,47158,277,264,13,NaN
08-Apr-2021,38113,210,187,23,NaN
09-Apr-2021,36048,225,205,20,NaN
10-Apr-2021,11188,88,82,6,NaN
11-Apr-2021,33688,141,134,7,NaN
12-Apr-2021,50871,221,217,4,NaN
13-Apr-2021,62973,201,157,44,NaN
14-Apr-2021,51476,202,174,28,NaN
15-Apr-2021,14218,97,94,3,NaN
16-Apr-2021,30592,107,90,17,NaN
17-Apr-2021,11152,88,76,12,NaN
18-Apr-2021,33945,142,130,12,4931
19-Apr-2021,46073,137,124,13,1540
20-Apr-2021,46359,160,141,19,2158
21-Apr-2021,41281,118,112,6,755
22-Apr-2021,31618,129,120,9,4300
23-Apr-2021,35245,112,101,11,NaN
24-Apr-2021,8762,41,29,12,1869
25-Apr-2021,28338,77,73,4,4355
26-Apr-2021,36111,96,87,9,NaN
27-Apr-2021,31255,88,77,11,2565
28-Apr-2021,34947,98,93,5,NaN
29-Apr-2021,31718,97,89,8,NaN
30-Apr-2021,35430,80,71,9,NaN
01-May-2021,9169,16,16,0,5303
02-May-2021,25567,52,49,3,5984
03-May-2021,33707,67,60,7,6534
04-May-2021,33889,63,63,0,3418
05-May-2021,34913,70,68,2,4474
06-May-2021,28526,50,50,0,5894
07-May-2021,32904,35,34,1,6249
08-May-2021,10397,18,18,0,2721
09-May-2021,23529,34,33,1,6093
10-May-2021,35517,55,54,1,7019
11-May-2021,31566,38,38,0,3586
12-May-2021,28694,28,28,0,3288
13-May-2021,20927,30,30,0,3875
14-May-2021,20244,29,29,0,4753
15-May-2021,5525,21,21,0,912
16-May-2021,14775,29,29,0,5448
17-May-2021,8745,15,15,0,3323
18-May-2021,23844,23,23,0,7756
19-May-2021,28412,59,59,0,5693
20-May-2021,22041,38,37,1,6901
21-May-2021,26955,23,23,0,5344
22-May-2021,6919,14,14,0,2298
23-May-2021,18390,26,26,0,7845
24-May-2021,32275,29,28,1,8524
25-May-2021,26674,24,23,1,4943
26-May-2021,25936,17,15,2,6408
27-May-2021,27738,13,11,2,8260
28-May-2021,31827,18,12,6,6195
29-May-2021,9340,13,11,2,3685
30-May-2021,19780,4,2,2,8697
31-May-2021,25471,14,1,13,10178
01-Jun-2021,21750,48,39,9,5652
02-Jun-2021,17243,14,13,1,6841
03-Jun-2021,15803,12,4,8,8909
04-Jun-2021,17991,31,24,7,6707
05-Jun-2021,7332,6,6,0,4422
06-Jun-2021,16034,5,1,4,10775
07-Jun-2021,23016,7,-6,13,11074
08-Jun-2021,21243,30,25,5,6095
09-Jun-2021,16937,7,3,4,8053
10-Jun-2021,17679,19,6,13,11483
11-Jun-2021,17477,18,7,11,8446
12-Jun-2021,10430,5,2,3,5049
13-Jun-2021,18547,3,-9,12,13524
14-Jun-2021,26332,26,3,23,13157
15-Jun-2021,22503,26,23,3,8011
16-Jun-2021,18399,13,9,4,9255
17-Jun-2021,16589,27,17,10,12875
18-Jun-2021,20294,35,26,9,10429
19-Jun-2021,12655,48,46,2,6241
20-Jun-2021,24652,49,44,5,15266
21-Jun-2021,32418,125,109,16,14843
22-Jun-2021,30911,110,92,18,9393
23-Jun-2021,29659,141,135,6,10135
24-Jun-2021,29887,233,218,15,14818
25-Jun-2021,39766,232,208,24,13493
26-Jun-2021,21859,116,106,10,7048
27-Jun-2021,30382,145,108,37,17415
28-Jun-2021,47671,287,242,45,16899
29-Jun-2021,46862,295,276,19,11959
30-Jun-2021,43642,312,278,34,12386
01-Jul-2021,44597,298,272,26,15719
02-Jul-2021,49700,329,296,33,12523
03-Jul-2021,27152,189,178,11,8203
04-Jul-2021,36504,353,321,32,17586
05-Jul-2021,53793,507,455,52,16264
06-Jul-2021,60686,529,477,52,13293
07-Jul-2021,54846,527,497,30,12447
08-Jul-2021,52116,472,405,67,17715
09-Jul-2021,61506,539,474,65,14850
10-Jul-2021,34576,266,236,30,10029
11-Jul-2021,42471,441,370,71,18380
12-Jul-2021,62139,764,612,152,17155
13-Jul-2021,62200,755,617,138,13951
14-Jul-2021,63080,781,715,66,14068
15-Jul-2021,65609,869,738,131,17181
16-Jul-2021,81877,1144,1059,85,14981
17-Jul-2021,33001,436,354,82,10209
18-Jul-2021,56702,842,702,140,16654
19-Jul-2021,84223,1386,1231,155,15616
20-Jul-2021,90595,1420,1309,111,12757
21-Jul-2021,85878,1352,1227,125,14435
22-Jul-2021,78815,1295,1127,168,22042
23-Jul-2021,98252,1443,1241,202,19728
24-Jul-2021,60719,973,827,146,15068
25-Jul-2021,77027,1419,1182,237,23939
26-Jul-2021,102783,2145,1920,225,21823
27-Jul-2021,106029,2303,2081,222,17862
28-Jul-2021,102848,2205,2004,201,19770
29-Jul-2021,102056,2188,1924,264,23263
30-Jul-2021,111132,2465,2301,164,18064
31-Jul-2021,73837,2121,1926,195,13178
01-Aug-2021,80658,2138,1932,206,19765
02-Aug-2021,113799,3878,3678,200,20030
03-Aug-2021,110669,3329,3166,163,15308
04-Aug-2021,117291,3534,3314,220,18978
05-Aug-2021,116110,3925,3677,248,19543
06-Aug-2021,116006,3931,3760,171,16198
07-Aug-2021,83868,2960,2858,102,8582
08-Aug-2021,92862,3464,3231,233,18235
09-Aug-2021,142078,6410,6172,238,19954
10-Aug-2021,132830,5888,5721,167,17216
11-Aug-2021,139704,6066,5858,208,12952
12-Aug-2021,129807,6181,5998,183,12865
13-Aug-2021,131063,6000,5861,139,11064
14-Aug-2021,83152,4249,4140,109,6996
15-Aug-2021,92696,5203,5026,177,17368
16-Aug-2021,152758,8811,8667,144,12976
17-Aug-2021,149332,8013,7900,113,10432
18-Aug-2021,151880,8031,7923,108,11278
19-Aug-2021,146490,7850,7674,176,14511
20-Aug-2021,150614,7927,7798,129,12219
21-Aug-2021,102453,5420,5371,49,6822
22-Aug-2021,110970,6616,6427,189,13512
23-Aug-2021,158484,10124,9982,142,14620
24-Aug-2021,155610,10093,9963,130,11169
25-Aug-2021,148614,9247,9107,140,12015
26-Aug-2021,149350,9135,8958,177,12875
27-Aug-2021,140100,8722,8598,124,10555
28-Aug-2021,107436,7347,7304,43,5730
29-Aug-2021,91352,6813,6691,122,11198
30-Aug-2021,152051,11154,11027,127,11871
31-Aug-2021,162325,10457,10344,113,8451
01-Sep-2021,149442,11304,11227,77,7582
02-Sep-2021,141043,11365,11281,84,9696
03-Sep-2021,149807,9925,9850,75,9637
04-Sep-2021,90418,5051,5022,29,4131
05-Sep-2021,114511,5861,5774,87,10118
06-Sep-2021,187193,10871,10832,39,7155
07-Sep-2021,98096,6871,6848,23,2827
08-Sep-2021,63281,3323,3308,15,4386
09-Sep-2021,136362,7976,6108,1868,19736
10-Sep-2021,181174,9892,8730,1162,16265
11-Sep-2021,166296,10297,10264,33,8511
12-Sep-2021,158519,7846,7486,360,14345
13-Sep-2021,189204,10947,10670,277,13180
14-Sep-2021,176508,9872,9666,206,13288
15-Sep-2021,159924,8904,8806,98,7273
16-Sep-2021,55104,3290,3289,1,20
17-Sep-2021,94192,5022,4961,61,13716
18-Sep-2021,144258,8647,8614,33,12032
19-Sep-2021,133156,6554,6453,101,19821
20-Sep-2021,181603,8827,8760,67,18193
21-Sep-2021,109004,4822,4766,56,10876
22-Sep-2021,112807,6032,5990,42,15893
23-Sep-2021,132040,6429,6351,78,19473
24-Sep-2021,121350,4983,4921,62,18612
25-Sep-2021,69969,2643,2606,37,15248
26-Sep-2021,98146,3851,3775,76,27495
27-Sep-2021,143125,5242,5140,102,28190
28-Sep-2021,75224,2420,2366,54,20514
29-Sep-2021,106468,3620,3565,55,21479
30-Sep-2021,121163,4377,4287,90,23442
01-Oct-2021,120101,3612,3540,72,19217
02-Oct-2021,65126,1725,1700,25,13272
03-Oct-2021,99670,2685,2614,71,20293
04-Oct-2021,126997,3253,3115,138,19699
05-Oct-2021,115582,2543,2452,91,14738
06-Oct-2021,109527,2400,2324,76,14177
07-Oct-2021,103786,2109,2037,72,18717
08-Oct-2021,105340,2012,1953,59,15881
09-Oct-2021,53564,1034,1020,14,9213
10-Oct-2021,83050,1491,1438,53,18227
11-Oct-2021,122870,2339,2275,64,17798
12-Oct-2021,111775,1795,1755,40,11978
13-Oct-2021,106894,1766,1724,42,11830
14-Oct-2021,95693,1340,1281,59,15833
15-Oct-2021,102732,1576,1537,39,14213
16-Oct-2021,46867,737,722,15,9919
17-Oct-2021,88863,1218,1183,35,18957
18-Oct-2021,111217,1501,1465,36,19128
19-Oct-2021,94325,1143,1111,32,13265
20-Oct-2021,103820,1031,1011,20,11945
21-Oct-2021,89672,995,936,59,17169
22-Oct-2021,96714,982,941,41,15562
23-Oct-2021,36764,329,313,16,10368
24-Oct-2021,87318,835,801,34,20343
25-Oct-2021,106429,926,890,36,18648
26-Oct-2021,91900,731,706,25,12374
27-Oct-2021,84772,643,607,36,12552
28-Oct-2021,76851,663,641,22,16296
29-Oct-2021,82468,622,594,28,14549
30-Oct-2021,37984,227,205,22,10380
31-Oct-2021,83926,532,481,51,22134
01-Nov-2021,96169,697,654,43,19056
02-Nov-2021,83166,668,638,30,14377
03-Nov-2021,86475,616,592,24,11876
04-Nov-2021,73844,523,496,27,16925
05-Nov-2021,77540,559,537,22,14457
06-Nov-2021,31073,198,172,26,12302
07-Nov-2021,86064,501,475,26,20875
08-Nov-2021,92872,571,533,38,19445
09-Nov-2021,85592,474,443,31,14867
10-Nov-2021,81468,495,478,17,12710
11-Nov-2021,73249,391,365,26,18611
12-Nov-2021,78780,449,427,22,14439
13-Nov-2021,34445,228,208,20,12286
14-Nov-2021,79226,398,371,27,20906
15-Nov-2021,92104,537,512,25,20589
16-Nov-2021,84770,559,527,32,13886
17-Nov-2021,74912,497,484,13,13772
18-Nov-2021,71547,472,437,35,19964
19-Nov-2021,83407,510,476,34,15591
20-Nov-2021,31774,235,217,18,13162
21-Nov-2021,82407,454,408,46,21605
22-Nov-2021,100303,715,686,29,21335
23-Nov-2021,89395,606,582,24,15702
24-Nov-2021,84484,545,522,23,14371
25-Nov-2021,83945,545,519,26,20431
26-Nov-2021,85176,544,519,25,16063
27-Nov-2021,35167,170,153,17,11983
28-Nov-2021,87127,537,486,51,23464
29-Nov-2021,112330,699,648,51,18965
30-Nov-2021,96475,577,538,39,14415
01-Dec-2021,99037,569,530,39,13840
02-Dec-2021,97538,519,445,74,19866
03-Dec-2021,96776,488,447,41,15948
04-Dec-2021,42366,249,219,30,11352
05-Dec-2021,95628,539,495,44,22070
06-Dec-2021,115082,738,668,70,20583
07-Dec-2021,116097,817,745,72,16526
08-Dec-2021,105535,709,648,61,13533
09-Dec-2021,101293,644,566,78,16680
10-Dec-2021,91641,603,501,102,12063
11-Dec-2021,39194,234,197,37,8542
12-Dec-2021,95472,492,398,94,14426
13-Dec-2021,109625,763,618,145,14701
14-Dec-2021,107461,700,525,175,12606
15-Dec-2021,104895,792,687,105,12009
16-Dec-2021,105624,862,689,173,16800
17-Dec-2021,102435,877,767,110,11047
18-Dec-2021,40767,373,305,68,9194
